329,329,329,329,329,329,329,329,329,329,329,329,329,329,329
329,329,329,329,329,329,329,329,329,329,329,329,329,329,329
329,329,369,329,369,329,369,329,369,329,369,329,369,329,329
329,329,329,329,329,329,369,329,369,329,329,329,329,329,329
329,329,369,329,369,329,369,329,369,329,369,329,369,329,329
329,329,329,329,329,329,329,329,329,329,329,329,329,329,329
329,329,369,329,369,369,369,329,369,369,369,329,369,329,329
329,329,329,329,329,329,329,329,329,329,329,329,329,329,329
329,329,369,329,369,369,369,329,369,369,369,329,369,329,329
329,329,329,329,329,329,329,329,329,329,329,329,329,329,329
329,329,369,329,369,329,369,329,369,329,369,329,369,329,329
329,329,329,329,329,329,369,329,369,329,329,329,329,329,329
329,329,369,329,369,329,369,329,369,329,369,329,369,329,329
329,329,329,329,329,329,329,329,329,329,329,329,329,329,329
329,329,329,329,329,329,329,329,329,329,329,329,329,329,329
